111111
1P00C1
101111
101E11
111111
