1111111
1111111
11P10C1
11110E1
1111111
