1111111111111
1C1E10P0000C1
1111111111111
