1111111111111
10000000000C1
1000000M00001
1000000000001
1000000000001
1010011110111
1P1011E0000C1
1111111111111
